ípido->ipídeo
iyo->iio
tóm->tôm
dioles->dióis
encil->enzil
anoles->anóis
ctósi->ctosí
njer->nxer
zoles#->zóis#
oyet->oiet
isac->issac
inj->enx
oinj->oenx
#ging->#geng
ayo#->aio#
idias->idías
sayo->saio
inur->inúr
itia->itía
sayo#->saio#
urea->uréia
poyet->poiet
inoles->inóis
nosu->nossu
enoid->enóid
inuri->inúri
pén->pên
diole->diói
iyod->iiod
zole->zói
epción->epção
safo->sefo
rrea#->rréia#
epción#->epção#
aveda->avida
cenc->cênc
ales#->ais#
ípid->ipíd
icion#->ições#
lípi->lipí
ptido->ptídeo
scop->scóp
osa-->ose-
ioles->ióis
scopi->scópi
icuerp->icorp
zoles->zóis
anoles#->anóis#
jer->xer
onur->onúr
orias->orías
olípi->olipí
hido->ído
injer->enxer
-yo->-io
renc->rênc
ehido->eído
erenc->erênc
duct->dut
osaf->osef
aved->avid
#inmu->#imu
disu->dissu
toin->toín
ales->ais
onuri->onúri
isul->issul
toina->toína
dihid->diid
azoles->azóis
onoid->onóid
dehido->deído
azoles#->azóis#
anoid->anóid
sa-->se-
oncia->ontia
inoid->inóid
ioles#->ióis#
inoles#->inóis#
osafo->osefo
isu->issu
ging->geng
encen->enzen
azole->azói
urea#->uréia#
eren->erên
ípi->ipí
itias->itías
cuerp->corp
say->sai
nje->nxe
inje->enxe
icion->ições
dioles#->dióis#
inmu->imu
noles#->nóis#
noles->nóis
itis#->ite#
ncen->nzen
noid->nóid
lectr->letr
copi->cópi
oina->oína
or#->ores#
géne->gêne
énes->ênes
génes->gênes
éne->êne
itis->ite
dehid->deíd
ogéne->ogêne
rrea->rréia
ogénes->ogênes
eroid->eróid
ructo->ruto
tis#->te#
oles#->óis#
rea#->réia#
ador#->adores#
tias->tías
nación#->nação#
nación->nação
nuri->núri
roid->róid
isa->issa
encia->ência
isis#->ise#
acin->azin
esis#->ese#
esión#->essão#
ihid->iid
esión->essão
coid->cóid
lación#->lação#
lación->lação
enoles->enóis
árid->aríd
ncil->nzil
ntoi->ntoí
vación->vação
árido->arídeo
enoles#->enóis#
vación#->vação#
osom->ossom
sco->scó
mación->mação
pción#->pção#
dehi->deí
eshid->esid
mación#->mação#
racin->razin
pción->pção
nesis->nese
iasis#->íase#
ea#->éia#
roles->róis
roles#->róis#
esis->ese
oles->óis
afía->afia
fía->fia
gamma->gama
scen->scên
cósi->cosí
icuer->icor
ayo->aio
poye->poie
#gamma->#gama
teli->téli
scenc->scênc
omía#->omia#
cienc->ciênc
afía#->afia#
cien->ciên
fía#->fia#
saf->sef
moso->mosso
ntación->ntação
ntación#->ntação#
iasis->íase
eroles#->eróis#
eroles->eróis
uria->úria
isis->ise
ación->ação
ación#->ação#
ad#->ade#
ruct->rut
r#->res#
orción#->orção#
ohep->oep
ofo#->ofós#
bilidad#->bilidade#
secc->ssec
furo#->feto#
gación#->gação#
axis->axia
orción->orção
lfuro#->lfeto#
onoi->onói
ud#->ude#
oinmu->oimu
tud#->tude#
rmo#->rma#
cua->qua
axis#->axia#
rción->rção
rción#->rção#
lfuro->lfeto
-y->-i
gación->gação
ehid->eíd
oid->óid
zación#->zação#
zación->zação
sido->sídeo
leóti->leotí
eóti->eotí
omía->omia
ose->osse
óme->ôme
lect->let
dad#->dade#
acári->acarí
tación->tação
tación#->tação#
ción->ção
ción#->ção#
óm->ôm
#inm->#im
dihi->dii
rición#->rição#
rición->rição
fo#->fós#
osis#->ose#
ótido->otídeo
ótid->otíd
inóge->inogê
xis#->xia#
poy->poi
ám->âm
anedi->anodi
anole->anói
ucto->uto
idad#->idade#
ición#->ição#
ición->ição
ómi->ômi
enb->emb
soles->sóis
soles#->sóis#
furo->feto
